zt	......	短縮よみ	
おやすみ	:aoi_sleep_in_huton::oyasumi_aoi::suyaa_akane::akane_sleep_i	短縮よみ	
ど	°C	短縮よみ	
くりしょう	クリ奨	短縮よみ	
ほよ	ほょ゜！	短縮よみ	
うれ	嬉	短縮よみ	
たかざわしゅんすけ	_(:3」∠)_	名詞	
たかざわじゅんすけ	_(:3」∠)_	名詞	
ぎ	⬜	サジェストのみ	
しん	☑️	サジェストのみ	
あrづいの	Arduino	固有名詞	
あせってん	a接点	名詞	
bせってん	b接点	名詞	
ごおgぇすぷれっどしーと	googleスプレッドシート	固有名詞	
ごおgぇどきゅめんと	googleドキュメント	固有名詞	
じぇつぉんあの	Jetson Nano	固有名詞	
いうしきー	イウしキー	名詞	
おまかん	おま環	短縮よみ	
たぶふ	タブ譜	名詞	
かかお	加々尾	名詞	
きぼうのつき	幾望の月	名詞	
きょうぷろ	競プロ	名詞	
けいほう	計法	名詞	
さんかくは	三角波	名詞	
しばん	指板	名詞	
しゅうちゅうせん	集中線	名詞	
はやびき	早弾き	名詞	
そくおんたい	測温体	名詞	
とうこうさい	投稿祭	名詞	
とうかがたこうでんせんさ	透過型光電センサ	名詞	
わそく	話速	名詞	
まいくら	マイクラ	名詞	ゲーム
ついのすてら	終のステラ	固有名詞	ゲーム/ノベル
さくらのうた	サクラノ詩	固有名詞	ゲーム/ノベル
いっぱんかい	一般解	名詞	学校
おんしつどせんさ	温湿度センサ	名詞	学校
くじ	苦地	固有名詞	人名/インターネット
いすかりゆば	柞刈湯葉	人名	人名/作家
zv	......	サジェストのみ	
ごじ	誤字	形容詞	
